12 12
0 0 0 0 0 0 0 0 0 0 0 0
0 0 W W W W 0 0 0 0 0 0
0 0 0 0 0 W W W W W W W
0 0 0 0 0 0 0 0 0 0 0 0
0 0 W W W W W W W 0 0 0
0 0 W 0 0 0 F W 0 0 0 0
0 0 W 0 0 W W W 0 0 0 0
0 0 W 0 0 W 0 0 0 0 0 0
0 0 W 0 0 W W W W 0 0 0
0 0 W 0 0 0 0 0 W W W 0
0 0 W 0 0 0 0 0 0 0 W 0
0 0 0 0 0 0 0 0 0 0 W 0