12 12
0 0 0 0 0 0 W 0 0 0 0 0
0 W W W W W W W 0 0 0 0
0 W 0 0 0 0 0 W 0 W 0 0
0 W 0 0 0 0 0 W F W 0 0
0 W 0 W W W 0 W W W 0 W
0 W 0 0 0 W 0 0 0 0 0 0
0 W 0 W W W 0 W W W W W
0 W 0 W 0 0 0 0 0 0 0 0
0 W 0 W 0 0 0 0 0 W 0 0
0 W 0 W 0 0 0 W W W 0 0
0 0 0 W 0 0 0 W 0 0 0 0
0 0 0 W 0 0 0 W 0 0 0 0
