7 6
0 0 0 0 0 0 0
0 0 0 0 0 0 0
0 0 0 0 0 0 0
0 0 0 0 W W 0
0 0 0 0 W F 0
0 0 0 0 W 0 0